000000000000000000000000
000000000000000000000000
000000000000000000000000
000000000000000000000000
000000000000000033333333
000000011100000003333333
000000100010000000033333
000000105000000000003333
000000100010000000000333
000000011100000000000000
000000000600000000000000
000000www000000000000000
00000wwwww00000000000333
00000wwwww00000000003333
00000wwwww00000000033333
000000www000000003333333
000000000000000033333333
000000000000000000000000
000000000000000000000000
000000000000000000000000
000000000000000000000000
000000000000000000000000
000000000000000000000000
000000000000000000000000