000000000000000000000000
000000000000000000000000
000000000000000000000000
000000000000000000000000
000000000000000033333333
000000011100000003333333
000000100010000000033333
000000105000000000003333
000000100010000000000333
00000001110007t008g00000
0000000006000yu00hj00000
000000www0000io00kl00000
00000wwwww00000000000333
00000wwwww00000000003333
00000wwwww00000000033333
000000www000000003333333
000000040000000033333333
000000000000000000000000
000000000000000000000000
000000000000000000000000
000000000000000000000000
000000000000000000000000
000000000000000000000000
000000000000000000000000