000000000000000000000000
000000000000000000000000
000000000000000000000000
000000000000000000000000
000000000000000033333330
000000011100000003333330
000000100010000000033330
000000105000000000003330
000000100010000000000330
000000011100000000000000
000000000000000000000000
000000www000000000000000
00000wwwww00000000000330
00000wwwww00000000003330
00000wwwww00000000033330
000000www000000003333330
000000000000000033333330
000000000000000000000000
000000000000000000000000
000000000000000000000000
000000000000000000000000
000000000000000000000000
000000000000000000000000
000000000000000000000000